3,3,3,3,3,3,3,3,3,3,3,3,3,3,3,3,3,3,3,3,3,3,3,3,3,3,3,3,3,3,3
3,2,2,2,2,2,2,2,2,2,2,2,2,2,2,2,2,2,2,1,1,1,2,2,2,2,2,2,2,2,3
3,2,2,2,2,2,2,2,2,2,2,2,2,1,2,2,2,2,2,1,5,1,8,2,2,2,2,2,2,2,3
3,1,2,2,2,2,2,2,2,2,2,2,2,2,2,2,2,2,2,1,1,8,2,2,2,2,2,2,2,2,3
3,2,2,2,2,2,1,2,2,2,2,2,2,2,2,1,2,2,2,8,2,2,2,2,2,2,2,2,2,2,3
3,2,2,2,2,2,2,1,2,2,2,2,2,2,2,2,2,2,2,2,2,2,2,2,2,2,8,8,8,2,3
3,2,2,2,2,2,2,2,2,2,2,8,2,2,2,2,2,2,2,1,4,2,2,2,2,2,8,6,8,2,3
3,2,2,2,2,2,2,2,2,2,2,2,2,2,8,2,2,2,2,2,2,2,2,2,2,2,8,8,8,2,3
3,3,3,3,3,3,3,3,3,3,3,3,3,3,3,3,3,3,3,3,3,3,3,3,3,3,3,3,3,3,3
